    MMMMMMMMMMMMMMMMMMMMMMMM
    M               M      M
    M M                    M
    M M                    M
    M M             M      M
    M M    BBBBBBBBBMM MMMMM
    M B    B B B B BM   MMMM
    M M    B       BM      M
    M M                 MMMM
    M M    B       BM      M
    M      B       BM   MMMM
    M      BBBB BBBBMMMMMMMM
    MMMMMMMMMMM MMMMMMMMMMMM
    M                      M
    MMMMMM MMMM MMMMMMMMMMMM
    MMMMMM MMMM MMMMMMMMMMMM
    M        MM MM     M   M
    M           MM  B  M   M
    M        MM MM     MM MM
    M M M    MM     B      M
    M  B     MM MM     MM MM
    M M M    MM MM  B  M   M
    M        MM MM     M   M
    MMMMMMMMMMMMMMMMMMMMMMMM