    MMMMMMMMMMMMMMMMMMMMMMMMM
    M      M        M      MM
    M M    MMMMMM          MM
    M M         M   M      MM
    M M   MMM       M      MM
    M M    BBBBBBBBBMM MMMMMM
    M B    B B B B BM   MMMMM
    M M M  B   M   BM      MM
    M M       MMM       MMMMM
    M M    B   M   BM      MM
    M      B       BM   MMMMM
    M      B BB BBBBMMMMMMMMM
    MMMMMMMM MM     MMMMM  MM
    M        M        B     M
    MMMMMM MMMM MMMMMMMMMMMMM
    MMMMMM MMMM MMMMMMMMMMMMM
    M        MM MM     M   MM
    M   MM     MM  B  M   MM
    M    M   MM MM     MM MMM
    M M M    MM     B      MM
    M  B  MM MM MM     MM MMM
    M M M    MM MM  B  M   MM
    M        MM MM     M   MM
    MMMMMMMMMMMMMMMMMMMMMMMMM
    MMMMMMMMMMMMMMMMMMMMMMMMM